111111111
11PC01111
111101111
1111E1111
111111111
111111111
111111111