111111111
100P00001
10C011111
1000E0001
111111111
100000001
111111111